b    b
bː    bː
d    d
dː    dː
e    e
ei    ei
eo    eo
eu    eu
ey    ey
eæ    eæ
eø    eø
eɑ    eɑ
eː    eː
f    f
fː    fː
g    gː
h    h
hː    hː
i    i
ie    ie
io    io
iu    iu
iy    iy
iæ    iæ
iø    iø
iɑ    iɑ
iː    iː
j    j
k    k
kː    kː
l    l
lː    lː
m    mː
n    n
nː    nː
o    o
oe    oe
oi    oi
ou    ou
oɑ    oɑ
oː    oː
p    p
pː    pː
r    r
rː    rː
s    s
sː    sː
t    t
tː    tː
u    u
ue    ue
ui    ui
uo    uo
uɑ    uɑ
uː    uː
v    v
y    y
ye    ye
yi    yi
yæ    yæ
yø    yø
yː    yː
æ    æ
æe    æe
æi    æi
æy    æy
æø    æø
æː    æː
ø    ø
øe    øe
øi    øi
øy    øy
øæ    øæ
øː    øː
ŋ    ŋ
ŋː    ŋː
ɑ    ɑ
ɑe    ɑe
ɑi    ɑi
ɑo    ɑo
ɑu    ɑu
ɑː    ɑː
    
tʰ    tsː
ɒ    øe
kʰ    k:
tʃ    t
õ    oe
a    yæ
aɪ    ae
eɪ    oe
ɫ    l:
ɪ     ia
ɪ    ia
ɪə    ea
l̩    lː
əʊ    æø
w    v
z    s
ʊ    oi
ʊə    oː
ʒ    v
ɛ    æø
ɛə    ɑe
m̩    r
dʒ    d
pʰ    p
ɔ    iɑ
ɜ    oe
n̩    nː
ɹ    iɑ
ʃ    nː
aʊ    eɑ
θ    yæ
ð    æø
ẽ    yː
ʌ    oː
ə    øe
ɔɪ    iɑ
